..########
.#e....###
.#####.###
.......###
####...###
######.###
#........#
#.####.#.#
#...##....
###....##s